###########
#.#.#.....#
#.#.#.###.#
#...#.###.#
#.###.#.#.#
#.#...#.#.#
#.###f#.#.#
#....###...
#.#.#.#.##.
i..........
