...........
..###......
..#.#......
....#..##..
..#.#..##..
..#......#.
..###f...#.
....i###..#
.....#.#...
........#..