.#.#..f.#.....#..#.#..##.#.#....#.#.#....#..#.#.#....#..#....#.....#..#.#..##.#.#....#.#.#....#..#.#...
#..#.#....#.#....#..##.#.#....#..#.#.#....#..#..#.#.#....#..#.#....#..#.#.#....#..#.#....#..##.#.#....#
.#..#.#....#..#.#.#....#..#.#....#..#.#.#....#..#..#.#.#....#..#.#....#..#.#.#....#..#..#.#.#....#..#..
#..#..#.#....#..#.#.#....#..#..#.#.#....#..#..#.#.#....#..#.#....#..#..#.#.#....#..#..#.#.#....#..#.#..
.#..#..#.#....#..#.#.#....#..#..#.#.#....#..#..#.#.#....#..#..#.#.#....#..#..#.#.#....#..#..#.#.#....#.
#..#..#..#.#....#..#.#.#....#..#..#.#.#....#..#..#.#.#....#..#..#.#.#....#..#..#.#.#....#..#..#.#.#..#.
.#..#..#..#.#....#..#.#.#....#..#..#.#.#....#..#..#.#.#....#..#..#.#.#....#..#..#.#.#....#..#..#.#.#...
#..#..#..#..#.#....#..#.#.#....#..#..#.#.#....#..#..#.#.#....#..#..#.#.#....#..#..#.#.#....#..#..#.#.#.
.#..#..#..#..#.#....#..#.#.#....#..#..#.#.#....#..#..#.#.#....#..#..#.#.#....#..#..#.#.#....#..#..#.#..
#..#..#..#..#..#.#....#..#.#.#....#..#..#.#.#....#..#..#.#.#....#..#..#.#.#....#..#..#.#.#....#..#..#..
.#..#..#..#..#..#.#....#..#.#.#....#..#..#.#.#....#..#..#.#.#....#..#..#.#.#....#..#..#.#.#....#..#..#.
#..#..#..#..#..#..#.#....#..#.#.#....#..#..#.#.#....#..#..#.#.#....#..#..#.#.#....#..#..#.#.#....#..#..
.#..#..#..#..#..#..#.#....#..#.#.#....#..#..#.#.#....#..#..#.#.#....#..#..#.#.#....#..#..#.#.#....#..#.
#..#..#..#..#..#..#..#.#....#..#.#.#....#..#..#.#.#....#..#..#.#.#....#..#..#.#.#....#..#..#.#.#....#..
.#..#..#..#..#..#..#..#.#....#..#.#.#....#..#..#.#.#....#..#..#.#.#....#..#..#.#.#....#..#..#.#.#....##
#..#..#..#..#..#..#..#..#.#....#..#.#.#....#..#..#.#.#....#..#..#.#.#....#..#..#.#.#....#..#..#.#.#...#
.#..#..#..#..#..#..#..#..#.#....#..#.#.#....#..#..#.#.#....#..#..#.#.#....#..#..#.#.#....#..#..#.#.#..#
#..#..#..#..#..#..#..#..#..#.#....#..#.#.#....#..#..#.#.#....#..#..#.#.#....#..#..#.#.#....#..#..#.#.#.
.#..#..#..#..#..#..#..#..#..#.#....#..#.#.#....#..#..#.#.#....#..#..#.#.#....#..#..#.#.#....#..#..#.#..
#..#..#..#..#..#..#..#..#..#..#.#....#..#.#.#....#..#..#.#.#....#..#..#.#.#....#..#..#.#.#....#..#..#..
.#..#..#..#..#..#..#..#..#..#..#.#....#..#.#.#....#..#..#.#.#....#..#..#.#.#....#..#..#.#.#....#..#..#.
#..#..#..#..#..#..#..#..#..#..#..#.#....#..#.#.#....#..#..#.#.#....#..#..#.#.#....#..#..#.#.#....#..#..
.#..#..#..#..#..#..#..#..#..#..#..#.#....#..#.#.#....#..#..#.#.#....#..#..#.#.#....#..#..#.#.#....#..#.
#..#..#..#..#..#..#..#..#..#..#..#..#.#....#..#.#.#....#..#..#.#.#....#..#..#.#.#....#..#..#.#.#....#..
.#..#..#..#..#..#..#..#..#..#..#..#..#.#....#..#.#.#....#..#..#.#.#....#..#..#.#.#....#..#..#.#.#....#.
#..#..#..#..#..#..#..#..#..#..#..#..#..#.#....#..#.#.#....#..#..#.#.#....#..#..#.#.#....#..#..#.#.#....
.#..#..#..#..#..#..#..#..#..#..#..#..#..#.#....#..#.#.#....#..#..#.#.#....#..#..#.#.#....#..#..#.#.#...
#..#..#..#..#..#..#..#..#..#..#..#..#..#..#.#....#..#.#.#....#..#..#.#.#....#..#..#.#.#....#..#..#.#.#.
.#..#..#..#..#..#..#..#..#..#..#..#..#..#..#.#....#..#.#.#....#..#..#.#.#....#..#..#.#.#....#..#..#.#..
#..#..#..#..#..#..#..#..#..#..#..#..#..#..#..#.#....#..#.#.#....#..#..#.#.#....#..#..#.#.#....#..#..#..
.#..#..#..#..#..#..#..#..#..#..#..#..#..#..#..#.#....#..#.#.#....#..#..#.#.#....#..#..#.#.#....#..#..#.
#..#..#..#..#..#..#..#..#..#..#..#..#..#..#..#..#.#....#..#.#.#....#..#..#.#.#....#..#..#.#.#....#..#..
.#..#..#..#..#..#..#..#..#..#..#..#..#..#..#..#..#.#....#..#.#.#....#..#..#.#.#....#..#..#.#.#....#..#.
#..#..#..#..#..#..#..#..#..#..#..#..#..#..#..#..#..#.#....#..#.#.#....#..#..#.#.#....#..#..#.#.#....#..
.#..#..#..#..#..#..#..#..#..#..#..#..#..#..#..#..#..#.#....#..#.#.#....#..#..#.#.#....#..#..#.#.#....#.
#..#..#..#..#..#..#..#..#..#..#..#..#..#..#..#..#..#..#.#....#..#.#.#....#..#..#.#.#....#..#..#.#.#....
.......................................................................................................
####################################################################################################...
.......................................................................................................
...#################################################################################################..#
....................................................................................................#..
######################################........................######################################...
......................................................................................................#
########..##############..###########################################################################..
......................................................................................................#
#..#####################..............########################......################################...
.......................................................................................................
########################################..#########################################################....
....................................................................................................###
############...#################..#################..#############..###################################
....................................................................................................###
########################..############...########.#########..##########################################
....................................................................................................###
################################################################################################.######
....................................................................................................###
###..#######################################################################################.....######
....................................................................................................###
############################..................................#########################################
....................................................................................................###
##...##################################################################################################
....................................................................................................###
##############################################################..................................i......
