..###.....
.#...##..#
.#.#..#...
.#.#.##.#.
.#.#......
.#.####...
.#....#...
.###f.#...
.....###i.
..........