####..#..#....#..##.#....#....###....#....##..
#..#..#..###.#.#..#.#..#.#.###..#.#.#.#..#.#..
#..####..#.#.#.#..#.#..#.#.#..#.#.#.#.#..#.#..
#.......#.#.#.#..#.#..#.#.#..#.#.#.#.#..#.#...
#.#####.#.#.#.#..#.#..#.#.#..#.#.#.#.#..###...
#.#...#.#.#.#.#..#.#..#.#.#..#.#.#.#.#........
#.#.#.#.#.#.#.#..#.#..#.#.#..#.#.#.#.#########
#.#.#.#.#.#.#.#..#.#..#.#.#..#.#.#.#.........#
#.#.#.#.#.#.#.#..#.#..#.#.#..#.#.#.#########.#
#.#.#.#.#.#.#.#..#.#..#.#.#..#.#.#.........#.#
#.#.#.#.#.#.#.#..#.#..#.#.#..#.#.#########.#.#
#.#.#.#.#.#.#.#..#.#..#.#.#..#.#.#.........#.#
#.#.#.#.#.#.#.#..#.#..#.#.#..#.#.#.#######.#.#
#.#.#.#.#.#.#.#..#.#..#.#.#..#.#.#.#.....#.#.#
#.#.#.#.#.#.#.#..#.#..#.#.#..#.#.#.#.###.#.#.#
#.#.#.#.#.#.#.#..#.#..#.#.#..#.#.#.#.#.#.#.#.#
#.#.#.#.#.#.#.#..#.#..#.#.#..#.#.#.#.#.#.#.#.#
#.#.#.#.#.#.#.#..#.#..#.#.#..#.#.#.#.#.#.#.#.#
#.#.#.#.#.#.#.#..#.#..#.#.#..#.#.#.#.#.#.#.#.#
#.#.#.#.#.#.#.#..#.#..#.#.#..#.#.#.#.#.#.#.#.#
#.#.#.#.#.#.#.#..#.#..#.#.#..#.#.#.#.#.#.#.#.#
#.#.#.#.#.#.#.#..#.#..#.#.#..#.#.#.#.#.#.#.#.#
#.#.#.#.#.#.#.#..#.#..#.#.#..#.#.#.#.#.#.#.#.#
#.#.#.#.#.#.#.#..#.#..#.#.#..#.#.#.#.#.#.#.#.#
#.#.#.#.#.#.#.#..#.#..#.#.#..#.#.#.#.#.#.#.#.#
#.#.#.#.#.#.#.#..#.#..#.#.#..#.#.#.#.#.#.#.#.#
#.#.#.#.#.#.#.#..#.#..#.#.#..#.#.#.#.#.#.#.#.#
#.#.#.#.#.#.#.#..#.#..#.#.#..#.#.#.#.#.#.#.#.#
#.#.#.#.#.#.#.#..#.#..#.#.#..#.#.#.#.#.#.#.#.#
#.#.#.#.#.#.#.#..#.#..#.#.#..#.#.#.#.#.#.#.#.#
#.#.#.#.#.#.#.#..#.#..#.#.#..#.#.#.#.#.#.#.#.#
#.#.#.#.#.#.#.#..#.#..#.#.#..#.#.#.#.#.#.#.#.#
#.#.#.#.#.#.#.#..#.#..#.#.#..#.#.#.#.#.#.#.#.#
#.#.#.#.#.#.#.#..#.#..#.#.#..#.#.#.#.#.#.#.#.#
#.#.#.#.#.#.#.#..#.#..#.#.#..#.#.#.#.#.#.#.#.#
#.#.#.#.#.#.#.#..#.#..#.#.#..#.#.#.#.#.#.#.#.#
#.#.#.#.#.#.#.#..#.#..#.#.#..#.#.#.#.#.#.#.#.#
#.#.#.#.#.#.#.#..#.#..#.#.#..#.#.#.#.#.#.#.#.#
#.#.#.#.#.#.#.#..#.#..#.#.#..#.#.#.#.#.#.#.#.#
#.#.#.#.#.#.#.#..#.#..#.#.#..#.#.#.#.#.#.#.#.#
#.#.#.#.#.#.#.#..#.#..#.#.#..#.#.#.#.#.#.#.#.#
#............................................#
###########################.#################
#.........................#.................#
#.#######################.#.###############.#
#.#.......................#.................#
#.#.#######################.###############.#
#.#.........................#...............#
#.#.#########################.##############.
#i............................f.............#
