..###....##.....#....#....
.#...##..#..###....#....#.
.#.#..#....#....###.#.#..#
.#.#.##.#..##.#.....#.#..#
.#.#......###.#.###....#..
.#.####...#...#...#####..#
.#....#...#.#.#.#.....#..#
.###f.#...#.#.#.###...#...
.....###i....#.....###....
.#..#....###.#.###.....#..
.#..###.....#.#...###.#..#
.#..#...###.#.#.#.....#..#
.#.####.#.#...###.#.###..#
....#....#.#.....#.#....#.
###.#.##.#.#####.#.##.#.#.
...#.#....#.....#....#.#..
.#.#.#.####.###.####.#.#..
.#.#.#......#.#.....#.#...
.#.#.########.#.#####.#...
.#.............#.....#....
.#.#############.#####.#..
.#...............#.....#..
.###########.######.###..#
.#...........#........#...
......###.....####.....#..
