..........
.....##...
..i..#f...
....##....
..........